R 2140 675
NO ./WALL76_1.xpm
SO ./WALL74_1.xpm
WE ./WALL40.xpm
EA ./redbrick.xpm
S ./cat.xpm
F 0,246,57
C 0,246,255
        
11111111111111111
10000001000000001
10000000100000001
10000001000000001
10001111111000001
10000000000000001
10000000020000001
1100N000000100001
10000000000000001
10000000000000001
10000000010000001
10000000000000001
10000000000200001
11110000000000011
10000000000000001
10000000000000001
10000000000000001   
10000000000000001
10000000000000001
10000000000000001
11111111111111111
